1111111111111
10010000001C1
10000111111E1
1P001110001C1
1111111111111