111111111111111
10010000000C001
101111111000001
1P1000000C00001
101111111100001
100000000000CE1
111111111111111
