1111111111111
10010000000C1
1000011110001
1P1001E000001
1111111111111