111111111111111111
1C0000C1001C0010P1
111001110011101011
100000000000000001
100011110001100111
10001E0000000001C1
111011111011100101
10000000001C000001
101001100011010011
1C100C1000000100C1
111111111111111111