1111111111111
1C1001C0010P1
1010011101011
1000000000001
1111001100111
1E0100C1001C1
1101011100101
100001C000001
1010011010011
1C100000100C1
1111111111111