11111111111111111111111111111
1C000000000000000000000000PC1
10000000000000000000000000001
10000000000000000000000000001
10000000000000000000000000001
1C0000000000000000000000000C1
10000000000000000000000000001
10000000000000000000000000001
10000000000000000000000000001
1000000000000000000000E000001
10000000000000000000000000001
10000000000000000000000000011
11111111111111111111111111111
