1111111111111111111111
1C00000X000X000X0000P1
1000011100111011100101
101C000X00000000000C01
1010111100011011100101
10001E00000X0000000101
1010111110011011010101
101C000000100X00000C01
1000111000110011001101
1C000000X0X000000000C1
1111111111111111111111