1111111111111
1C1C01C0010P1
101X011101011
100000X000001
11110011X0111
1E0100C1001C1
110101110X101
100001C000001
1010011010X11
1C1X0000100C1
1111111111111